NO srcs/lavaboy.xpm
SO srcs/bloque.xpm
WE srcs/puerta.xpm
EA srcs/flor.xpm

F 141,25,37
C 00,153,164

11111111111111
1            1
1 111111111  1
1 100000001  111111
1 100000001       1
1 10000N001111111 1
1 100000000000001 1
1 111111111111111 1
1                 1
1111111111111111111
