NO ./textures/wall_1.xpm
SO ./textures/wall_2.xpm
WE ./textures/wall_3.xpm
EA ./textures/wall_4.xpm
DOOR ./textures/door.xpm

C 225,0,0
F 0,0,255

BEGIN SPRITES
END SPRITES

BEGIN POS
END POS

        1111111111111111111111111
        1000000000110000000000001
        1011000001110000000000001
        1001000000000000000000001
111111111011000001110000000000001
100000000011000001110111111O11111
11110111111111011100000010001
11110111111111011101010010001
11000000110101011100000010001
1000000000000000C000000010001
10000000000000001101010010001
11000001110101011111011010N0111
11110111 1110101 1011110C0001
11111111 1111111 111111111111
