NO textures/eagle.xpm
SO textures/wood.xpm
WE textures/wall_3.xpm
EA textures/wall_4.xpm

F 141,25,37
C 00,153,164

1111111111111111111
1                 1
1 111111111       1
1 100000001       1
1 100000001       1
1 100000001111111 1
1 1000000000000S1 1
1 111111111111111 1
1                 1
1111111111111111111
