NO ./textures/white.xpm
SO ./textures/red.xpm
WE ./textures/green.xpm
EA ./textures/blue.xpm
DOOR ./textures/door.xpm

C 28,28,28
F 28,28,28

BEGIN SPRITES
END SPRITES

BEGIN POS
END POS

11111
10001
10S01
10001
11111
